6 6
-1 -1 -1 -1 -1 -1
-1  3  1  3  1 -1
-1  1  1  1  1 -1
-1  2  0  2  1 -1
-1  1  1  1  1 -1
-1 -1 -1 -1 -1 -1
    